15 15 12 3
+++++++++++++++
+--+++++++++--+
+-++++++1++++-+
+++++++++++++++
+++++++++++++++
+++++++++++++++
+++1+++++++++++
+++++++++++++++
+++++++++++++++
+++++++++++++++
++++++++1++++++
+++++++++++++++
+-+++++++++++-+
+--+++++++++--+
+++++++++++++++