20 20 30 6
++++++++++++++++++++
+-++++++++++++++++++
+-+++++++++2++++++++
+-++++++++++++++++++
+-++++++++++++++++++
+-++++++++++++++++++
+-++++++--++++++++++
+-+++2+++-++++++++++
+-+++++++-++++++++++
+---------++++++++++
+-++++++++++++++++++
++++++++++++++1+++-+
++++++++++++++++++-+
+++++++1++++++++++-+
++++++++++++++++++-+
++++++++++++++++++-+
++++1+++++++++++++-+
++++++++++++++++++-+
+++++++++++++2++++-+
++++++++++++++++++++